kustle	reshix
beckel	racual
puggle	entand
chadop	shaple
chulks	vulhor
werner	hurmer
mecket	plumry
gukbar	soarse
clidge	hensly
schook	jabant
spunge	wenple
shrile	athoid
cosutz	spover
coamin	mucond
shamer	bloifs
middor	drooty
ancits	smeath
pengyl	sedest
hadder	ollidy
zetten	unfobs
fleeve	scalfs
tiklet	hullaw
shurry	preser
monter	melelt
strant	potind
pluset	stubad
umpond	marire
russer	huttle
cather	funder
tecker	biller
birler	enciad
raster	movell
menner	nandow
bameta	unzast
pliper	sesare
coppar	hunene
sporer	firtly
pirter	secent
pobbit	spippy
padnet	fanely
boddle	molill
devole	sholly
jallem	sildal
dorder	coggon
puctor	recure
chevel	podden
awplor	fasees
ingell	nalill
bemble	squank
isbant	unairs
